light chartreuse|mirrored yellow|vibrant violet|
dotted silver|dotted orange|bright fuchsia|bright tomato|faded turquoise|
plaid indigo|pale violet|mirrored violet|
faded turquoise|faded lavender|
striped yellow|vibrant black|mirrored gold|
dull tan|vibrant aqua|
striped brown|vibrant orange|posh bronze|dim purple|
bright teal|muted cyan|drab white|drab gray|
wavy tan|wavy tomato|dim tan|
light lavender|dotted black|wavy maroon|pale white|clear tan|
dull orange|bright brown|muted gold|vibrant black|posh bronze|
posh cyan|mirrored tomato|light salmon|faded brown|vibrant red|
dark lavender|faded purple|
dark white|muted green|
striped olive|muted chartreuse|
bright crimson|drab salmon|faded plum|shiny brown|pale orange|
dark tomato|dim aqua|
light olive|drab blue|plaid purple|
muted gray|mirrored plum|
bright salmon|striped plum|dull silver|striped indigo|striped cyan|
wavy gold|drab tomato|pale gold|plaid tan|vibrant gold|
muted fuchsia|vibrant plum|clear chartreuse|pale white|
light purple|vibrant olive|bright maroon|posh tomato|
vibrant gray|shiny silver|
vibrant beige|pale crimson|pale olive|posh yellow|dotted orange|
drab beige|faded gold|mirrored fuchsia|
light white|vibrant fuchsia|posh tomato|muted chartreuse|
posh lavender|dim fuchsia|light violet|wavy aqua|vibrant lime|
vibrant fuchsia|wavy tomato|plaid purple|
bright fuchsia|faded tomato|bright salmon|bright red|
dim bronze|drab blue|
wavy brown|dotted crimson|
striped plum|bright tomato|
posh coral|mirrored gray|posh silver|
wavy teal|dark bronze|
posh crimson|bright tomato|wavy violet|striped olive|
dark beige|drab turquoise|
dull green|vibrant purple|dark red|
wavy violet|faded lavender|faded turquoise|shiny brown|
wavy crimson|muted lavender|
light maroon|bright magenta|dim yellow|faded violet|
muted white|muted purple|plaid gray|vibrant maroon|
striped silver|shiny red|vibrant coral|
clear chartreuse|pale gold|
posh silver|vibrant aqua|muted coral|drab crimson|clear tan|
plaid green|striped lavender|dim fuchsia|vibrant black|
muted turquoise|faded green|striped silver|
faded blue|pale crimson|
dull magenta|striped brown|posh black|dark teal|
dotted white|dotted magenta|bright lavender|drab crimson|drab silver|
shiny orange|pale violet|
vibrant blue|clear yellow|muted beige|
dull blue|pale violet|dotted orange|
bright olive|dotted teal|dotted violet|
faded gray|bright maroon|shiny crimson|plaid lavender|
clear tomato|vibrant white|bright gold|vibrant chartreuse|posh violet|
bright indigo|wavy gold|vibrant indigo|mirrored chartreuse|
clear indigo|plaid gray|faded gold|clear beige|
dotted crimson|pale gold|vibrant salmon|posh maroon|
drab red|vibrant chartreuse|wavy beige|pale olive|clear white|
clear black|faded chartreuse|striped brown|wavy crimson|pale tomato|
shiny bronze|dark tan|
posh indigo|clear plum|dotted red|dull crimson|dotted bronze|
dark cyan|plaid tan|dim bronze|
shiny chartreuse|dark tomato|striped salmon|
dim brown|pale olive|posh tomato|
faded green|drab violet|vibrant gray|
dull salmon|muted coral|muted brown|striped coral|dark white|
wavy white|muted lime|striped purple|
dim aqua|striped beige|striped silver|bright cyan|clear blue|
dim salmon|mirrored lime|vibrant plum|mirrored fuchsia|shiny gold|
dotted fuchsia|striped indigo|wavy coral|
faded tan|dotted gold|
drab white|posh violet|
muted teal|dotted purple|dark maroon|dotted magenta|pale beige|
dark magenta|posh red|
shiny cyan|dull red|light coral|
plaid blue|shiny gold|dull salmon|vibrant silver|light salmon|
dim orange|vibrant salmon|dotted teal|
vibrant bronze|striped blue|clear magenta|
faded olive|muted beige|wavy beige|
dotted lime|mirrored tan|
dark silver|vibrant plum|shiny gold|light crimson|dark cyan|
mirrored orange|shiny blue|faded olive|posh gold|
clear magenta|pale olive|
wavy blue|light gray|
pale maroon|dim aqua|dotted fuchsia|clear brown|drab turquoise|
muted purple|no other|
vibrant plum|wavy beige|
mirrored gray|dull plum|pale blue|
striped lavender|wavy tomato|striped tan|posh silver|
dark violet|muted olive|drab crimson|
bright tomato|pale violet|
posh white|clear white|striped plum|drab crimson|wavy beige|
striped bronze|shiny teal|bright lavender|dark beige|
clear beige|mirrored magenta|muted olive|mirrored violet|
striped teal|mirrored cyan|posh crimson|vibrant tan|
bright blue|faded indigo|wavy green|
striped orange|vibrant coral|faded lavender|vibrant maroon|plaid cyan|
dim yellow|pale violet|muted plum|pale coral|pale yellow|
dark bronze|posh gray|
wavy purple|faded tomato|striped green|striped tan|dotted fuchsia|
light fuchsia|shiny lime|dotted teal|muted brown|
muted orange|striped chartreuse|dim salmon|pale indigo|
dotted green|dotted maroon|vibrant beige|striped beige|
wavy gray|mirrored fuchsia|mirrored chartreuse|mirrored blue|
dotted yellow|light tomato|dull indigo|
light aqua|shiny brown|bright coral|
muted cyan|faded olive|pale white|plaid tan|
pale tan|bright cyan|
vibrant magenta|light magenta|
light turquoise|dim bronze|faded olive|light orange|shiny green|
light bronze|vibrant black|clear indigo|
vibrant purple|bright red|vibrant violet|
vibrant red|mirrored fuchsia|drab tomato|
mirrored crimson|posh purple|dotted magenta|
wavy olive|dark fuchsia|
pale beige|striped coral|shiny violet|
posh teal|dull violet|drab gold|muted chartreuse|drab turquoise|
faded tomato|mirrored salmon|wavy coral|
muted salmon|vibrant gray|
dim lavender|clear lavender|dotted coral|
shiny yellow|dim purple|
light tan|vibrant plum|dim tomato|
shiny violet|mirrored salmon|
drab black|dark coral|muted beige|plaid orange|dark tan|
wavy bronze|wavy lime|striped white|drab gray|light orange|
bright green|vibrant gold|vibrant tomato|dim teal|
striped gold|striped purple|faded purple|dark beige|mirrored silver|
wavy green|mirrored tan|muted cyan|plaid turquoise|drab gray|
striped salmon|light yellow|
bright orange|shiny orange|
mirrored white|clear fuchsia|
striped coral|no other|
light magenta|faded gold|drab lime|
dull tomato|pale indigo|pale white|wavy silver|faded indigo|
light black|dark lavender|light blue|dull turquoise|
posh fuchsia|wavy gold|vibrant plum|posh white|
shiny indigo|posh plum|pale lime|muted blue|clear tan|
mirrored blue|dark indigo|vibrant coral|mirrored salmon|
pale tomato|plaid purple|wavy violet|
dull silver|striped beige|shiny lime|muted olive|dull blue|
mirrored silver|wavy coral|dark lavender|dull violet|
drab turquoise|dim purple|clear white|dull brown|
drab violet|pale white|bright cyan|
pale indigo|striped blue|plaid turquoise|striped beige|
shiny fuchsia|striped olive|vibrant orange|striped indigo|vibrant lime|
bright maroon|clear chartreuse|
shiny tomato|pale gold|plaid gold|dark white|
dotted olive|vibrant silver|posh crimson|
drab teal|faded indigo|
muted plum|mirrored gray|wavy maroon|mirrored tomato|drab crimson|
muted violet|drab crimson|
dark brown|shiny violet|bright coral|vibrant plum|plaid silver|
posh purple|dull silver|posh salmon|dull chartreuse|
light yellow|striped olive|mirrored tomato|wavy plum|
bright silver|pale bronze|drab turquoise|striped coral|
dotted indigo|mirrored brown|dim teal|
bright lavender|dark indigo|wavy brown|dotted tomato|plaid beige|
drab purple|mirrored bronze|
clear olive|wavy red|muted bronze|dotted chartreuse|
mirrored coral|shiny salmon|light orange|faded yellow|shiny maroon|
clear fuchsia|pale blue|light lavender|clear blue|posh maroon|
drab fuchsia|drab bronze|shiny bronze|
pale blue|dim purple|plaid purple|vibrant coral|
clear violet|muted chartreuse|
clear brown|faded chartreuse|dotted plum|mirrored plum|plaid red|
muted maroon|muted chartreuse|striped silver|posh yellow|dark indigo|
dim olive|clear beige|pale blue|
bright violet|shiny salmon|dull teal|shiny blue|posh teal|
drab green|wavy aqua|dark lavender|dull tan|
dim turquoise|dark brown|dotted crimson|dull salmon|
vibrant teal|dotted coral|dim white|
posh maroon|muted purple|bright tomato|
faded aqua|posh white|mirrored violet|
vibrant violet|vibrant crimson|drab crimson|
dotted salmon|faded violet|clear beige|bright coral|
dull chartreuse|dotted fuchsia|posh black|bright green|
vibrant orange|shiny green|dull blue|
mirrored indigo|dull beige|
drab lavender|striped lime|
bright gold|posh silver|
dull fuchsia|striped tomato|
light lime|striped orange|
wavy magenta|clear fuchsia|muted brown|plaid lavender|clear green|
faded beige|mirrored plum|light blue|dim purple|plaid violet|
dark plum|shiny red|shiny blue|striped blue|drab gray|
wavy turquoise|dim turquoise|striped lavender|drab aqua|
shiny white|shiny violet|muted bronze|clear tomato|
plaid yellow|vibrant indigo|light gray|
dim crimson|dim brown|dim white|vibrant silver|drab teal|
dim tomato|dull silver|light gray|
wavy cyan|dark chartreuse|dark maroon|mirrored brown|dotted fuchsia|
dim green|striped lime|bright gold|vibrant violet|muted beige|
striped maroon|mirrored plum|drab lavender|posh teal|
dotted gray|vibrant white|pale violet|
dotted beige|drab aqua|
clear crimson|dim white|faded magenta|dim tomato|
pale olive|posh tomato|
posh orange|muted cyan|faded turquoise|
posh yellow|dotted orange|striped crimson|
striped black|dark black|faded magenta|pale lavender|
faded orange|bright bronze|
pale turquoise|posh maroon|faded violet|faded lavender|vibrant lime|
clear gray|posh gray|shiny silver|vibrant purple|faded lavender|
shiny olive|vibrant lime|faded coral|
vibrant maroon|light gray|
drab silver|vibrant salmon|clear tan|light white|
posh turquoise|plaid green|light bronze|shiny turquoise|clear gray|
mirrored cyan|clear white|
shiny silver|vibrant coral|
clear plum|muted lavender|striped coral|
dark crimson|posh violet|
muted red|dim maroon|bright fuchsia|dotted green|striped gold|
clear lime|plaid cyan|dim gray|muted violet|
faded purple|muted beige|posh white|drab turquoise|
mirrored yellow|striped tan|
dim gray|bright green|muted black|mirrored maroon|mirrored violet|
mirrored tomato|muted olive|mirrored lime|
faded coral|bright brown|vibrant purple|posh coral|
wavy fuchsia|dim salmon|vibrant violet|muted beige|dotted black|
light plum|wavy black|
dark tan|wavy green|faded turquoise|dark bronze|light violet|
wavy beige|no other|
dotted aqua|mirrored turquoise|clear blue|dotted teal|bright bronze|
clear tan|clear gold|plaid purple|striped indigo|bright tomato|
dark red|vibrant maroon|vibrant fuchsia|pale lavender|dim purple|
dim violet|drab tomato|vibrant white|faded lavender|
dull gray|vibrant black|
mirrored aqua|clear fuchsia|muted chartreuse|
pale violet|no other|
faded silver|mirrored lime|muted beige|mirrored black|clear gold|
posh tomato|dim purple|vibrant maroon|
mirrored bronze|mirrored gold|faded purple|plaid cyan|faded gold|
light red|muted black|
wavy salmon|light white|clear white|dark maroon|
posh lime|drab gold|
wavy chartreuse|muted teal|plaid salmon|
dotted tomato|striped white|dark lavender|
vibrant crimson|no other|
posh violet|shiny lavender|striped coral|mirrored tan|
shiny lime|mirrored lime|drab blue|
dotted magenta|bright salmon|
pale white|faded olive|vibrant tomato|
muted lime|muted aqua|
dotted lavender|dim chartreuse|vibrant olive|
faded crimson|bright plum|dotted cyan|
drab tan|dim orange|light teal|light indigo|
pale black|posh silver|
dark orange|muted black|pale violet|faded cyan|
mirrored violet|faded olive|vibrant crimson|
posh plum|vibrant maroon|
clear turquoise|dim purple|
plaid gray|dotted crimson|
pale salmon|vibrant aqua|wavy blue|striped violet|
pale gold|striped coral|
bright plum|faded aqua|
pale red|dotted silver|clear chartreuse|vibrant salmon|
striped tan|drab crimson|
mirrored red|striped gold|mirrored gray|
bright turquoise|plaid blue|clear tomato|drab yellow|vibrant black|
dark maroon|shiny magenta|dotted fuchsia|dull brown|posh violet|
plaid chartreuse|drab gold|vibrant white|muted coral|clear plum|
posh black|shiny brown|posh white|dim gray|
dotted teal|plaid bronze|light violet|muted beige|
plaid lime|mirrored black|muted plum|shiny maroon|dim beige|
dim teal|muted coral|
vibrant aqua|no other|
dotted turquoise|posh violet|
vibrant lime|dark bronze|vibrant maroon|mirrored cyan|
shiny gray|muted coral|bright coral|
clear white|dim purple|
shiny salmon|dull tan|posh violet|mirrored magenta|plaid tan|
dark gold|mirrored gray|vibrant coral|
drab salmon|dull indigo|
faded salmon|bright blue|
vibrant salmon|muted purple|striped plum|
dull red|pale white|
muted yellow|pale beige|dim indigo|
bright beige|muted lavender|dotted silver|shiny bronze|
dull gold|posh gold|
striped crimson|dull blue|bright gold|shiny lavender|
drab maroon|wavy fuchsia|
wavy plum|posh tan|muted maroon|
bright black|dark white|dull maroon|
plaid aqua|wavy gray|shiny blue|
wavy silver|bright tomato|
clear orange|dark brown|wavy bronze|bright tomato|faded olive|
shiny lavender|dim purple|
dull crimson|bright plum|pale yellow|
vibrant brown|dull tan|pale yellow|striped orange|
striped white|pale orange|
light blue|vibrant red|bright cyan|vibrant brown|dim beige|
dark green|dotted black|
plaid black|dotted chartreuse|wavy yellow|faded cyan|posh orange|
shiny turquoise|vibrant tan|vibrant salmon|muted olive|
clear silver|drab crimson|bright magenta|shiny blue|drab lavender|
muted chartreuse|mirrored tan|
mirrored brown|clear yellow|clear violet|wavy plum|
dull white|shiny blue|plaid tan|vibrant silver|pale orange|
clear lavender|posh bronze|
light gold|striped cyan|dark lime|
plaid coral|posh salmon|striped purple|bright blue|
faded magenta|posh yellow|bright plum|
faded maroon|plaid gray|
clear green|vibrant silver|shiny gold|
mirrored tan|plaid purple|dim purple|vibrant crimson|
striped red|clear salmon|
dull aqua|plaid red|vibrant aqua|
bright coral|muted fuchsia|wavy beige|
wavy black|drab crimson|vibrant white|vibrant aqua|
dim white|dull olive|vibrant white|
striped turquoise|drab turquoise|
shiny gold|mirrored blue|muted brown|dim purple|
bright gray|faded cyan|dark plum|light violet|
mirrored olive|vibrant gray|plaid blue|clear black|dotted black|
posh red|muted olive|dotted coral|striped crimson|
clear teal|bright gold|striped gray|mirrored lime|wavy indigo|
faded lime|plaid beige|
dull yellow|clear indigo|drab beige|plaid bronze|
muted beige|no other|
wavy orange|shiny lime|striped gold|
drab brown|bright red|posh yellow|dotted gray|plaid green|
muted olive|posh maroon|bright maroon|faded olive|
dotted cyan|dotted purple|pale olive|dull plum|
vibrant olive|light violet|dim violet|mirrored black|
pale lime|dark purple|shiny chartreuse|
dull purple|faded blue|dull violet|dim bronze|vibrant crimson|
dotted red|bright magenta|mirrored cyan|wavy green|dotted cyan|
vibrant silver|faded purple|shiny yellow|mirrored tan|
dark fuchsia|dark cyan|
muted crimson|bright tomato|dark gold|
dark coral|faded magenta|
dull teal|drab turquoise|dim salmon|striped coral|
light brown|bright tomato|mirrored salmon|vibrant violet|dark bronze|
bright brown|muted purple|vibrant yellow|pale fuchsia|posh violet|
faded bronze|bright bronze|dim tomato|mirrored beige|
dim indigo|vibrant gold|
drab cyan|muted orange|dotted orange|striped tan|dull turquoise|
mirrored plum|dotted black|faded silver|plaid red|
dull maroon|dark violet|bright brown|clear blue|
light silver|bright blue|muted brown|
dim blue|dim purple|pale orange|
clear blue|plaid tan|muted chartreuse|faded lavender|
mirrored salmon|striped coral|plaid purple|
faded violet|clear gold|posh white|
light beige|vibrant tan|muted lavender|plaid bronze|
shiny black|vibrant violet|wavy brown|
dotted plum|faded yellow|light lavender|
vibrant chartreuse|mirrored fuchsia|
striped green|wavy lime|mirrored turquoise|muted aqua|wavy gold|
plaid plum|plaid tan|pale gold|mirrored salmon|
dark chartreuse|bright orange|bright lavender|light black|
muted indigo|posh fuchsia|
posh tan|dull silver|clear tan|drab beige|
shiny brown|shiny gold|
pale orange|striped gray|clear beige|
pale lavender|shiny lime|bright cyan|
pale bronze|faded blue|pale yellow|shiny red|
muted bronze|light beige|muted fuchsia|striped chartreuse|
light crimson|faded coral|
drab coral|faded black|drab white|wavy maroon|muted violet|
vibrant lavender|striped crimson|
posh magenta|bright chartreuse|drab white|dull violet|
dim maroon|drab lime|faded aqua|dark lavender|
clear purple|pale lavender|
dim magenta|dull violet|pale red|
plaid red|clear indigo|
light gray|dark white|posh green|wavy silver|
plaid beige|dotted brown|clear white|
faded gold|clear white|muted purple|striped plum|
drab yellow|striped lime|muted fuchsia|wavy black|pale white|
dark indigo|striped indigo|mirrored violet|muted brown|
muted black|plaid tan|bright tomato|
shiny beige|dark bronze|
bright cyan|dark lavender|striped plum|mirrored tan|plaid teal|
dotted gold|pale gold|drab silver|
wavy tomato|dotted crimson|mirrored lime|dim indigo|
muted aqua|muted beige|
plaid white|bright green|mirrored blue|dull maroon|dotted chartreuse|
plaid teal|plaid tan|wavy beige|
light salmon|faded turquoise|muted green|plaid bronze|plaid indigo|
dark aqua|wavy plum|dotted red|light red|
pale aqua|light aqua|clear cyan|dull tan|bright olive|
posh green|pale blue|
faded chartreuse|shiny red|
pale purple|mirrored cyan|
striped magenta|muted aqua|plaid turquoise|dim purple|wavy red|
plaid crimson|muted brown|mirrored tomato|
plaid orange|dotted salmon|pale aqua|shiny tomato|dull salmon|
faded red|clear tan|
plaid fuchsia|dark black|dotted teal|dark aqua|dull bronze|
pale crimson|dull brown|vibrant coral|
muted lavender|posh silver|plaid cyan|
dull violet|posh coral|shiny red|drab gold|posh white|
dull coral|bright lime|
posh gold|vibrant violet|muted lavender|
drab lime|shiny salmon|plaid plum|wavy tomato|wavy red|
plaid tan|muted purple|
posh chartreuse|clear white|dotted violet|light teal|vibrant gold|
faded yellow|muted coral|shiny yellow|shiny lime|
vibrant cyan|muted purple|pale tomato|vibrant beige|muted black|
plaid tomato|faded fuchsia|
dotted maroon|dull tan|plaid cyan|bright gold|drab blue|
drab gray|faded olive|vibrant crimson|
wavy maroon|wavy red|posh white|wavy tomato|
dull lavender|dim salmon|dotted aqua|dim turquoise|muted gold|
dim chartreuse|muted yellow|muted violet|shiny orange|drab salmon|
bright red|dull red|muted fuchsia|
clear yellow|dim violet|dim tomato|pale indigo|
wavy aqua|shiny red|pale gold|mirrored blue|dull violet|
bright lime|posh tomato|faded fuchsia|posh yellow|dull brown|
bright chartreuse|posh fuchsia|posh yellow|dotted chartreuse|
mirrored magenta|shiny teal|mirrored maroon|drab turquoise|
pale yellow|plaid purple|vibrant black|
dark teal|clear salmon|mirrored blue|pale blue|
clear coral|dark indigo|dark plum|plaid beige|
muted brown|no other|
dotted purple|posh bronze|vibrant chartreuse|striped indigo|
plaid violet|posh white|
dull turquoise|drab red|muted aqua|drab violet|muted purple|
light coral|posh bronze|vibrant silver|
striped lime|muted olive|
pale cyan|mirrored tomato|dull red|striped indigo|dark maroon|
muted tomato|posh tomato|dim teal|drab indigo|
shiny coral|mirrored beige|muted magenta|light green|mirrored olive|
vibrant black|dotted black|dull red|light lavender|
vibrant green|mirrored bronze|dotted teal|plaid tomato|muted purple|
clear aqua|plaid teal|posh tomato|light bronze|posh teal|
dotted brown|pale white|dim indigo|shiny yellow|plaid gray|
striped beige|striped indigo|faded lavender|drab crimson|vibrant tomato|
plaid cyan|shiny gold|wavy beige|
mirrored gold|vibrant coral|
plaid turquoise|striped coral|
pale magenta|drab tomato|dark chartreuse|striped tan|vibrant white|
pale green|shiny tan|
faded indigo|bright plum|posh teal|
dim red|striped silver|dim blue|
bright tan|vibrant cyan|mirrored magenta|
dotted violet|bright bronze|dotted silver|drab silver|plaid indigo|
dim black|dark magenta|vibrant tan|light magenta|
bright aqua|muted gold|dotted gray|
plaid salmon|vibrant gold|bright maroon|shiny lime|mirrored salmon|
drab chartreuse|shiny crimson|
shiny magenta|striped plum|
dotted blue|muted salmon|
bright white|pale olive|dotted black|
clear red|bright chartreuse|striped magenta|
mirrored chartreuse|vibrant crimson|drab blue|
striped fuchsia|muted salmon|posh bronze|
posh blue|faded bronze|striped purple|
mirrored fuchsia|mirrored tan|muted coral|
posh beige|drab violet|
striped violet|wavy plum|pale crimson|
vibrant turquoise|plaid gray|
dotted bronze|drab maroon|posh plum|dotted brown|mirrored cyan|
dim cyan|pale orange|posh white|plaid salmon|
vibrant gold|bright coral|mirrored black|
posh bronze|bright green|faded turquoise|plaid plum|dull tan|
pale chartreuse|vibrant gray|posh coral|bright white|faded white|
drab crimson|wavy beige|striped coral|dim purple|pale gold|
mirrored lime|striped coral|wavy beige|
shiny green|plaid silver|dim teal|dotted teal|drab turquoise|
light tomato|dark gold|
mirrored beige|posh gray|dull olive|drab crimson|striped silver|
vibrant indigo|pale brown|vibrant tomato|dim violet|
dim plum|plaid aqua|wavy plum|wavy aqua|
light indigo|mirrored purple|
faded brown|dim gold|
dim gold|dotted purple|dotted black|vibrant beige|clear magenta|
clear cyan|mirrored blue|clear gray|
dark yellow|dull violet|dotted crimson|dark bronze|vibrant tomato|
plaid silver|drab gray|
vibrant yellow|plaid teal|shiny silver|mirrored black|
dull olive|dark bronze|wavy green|muted cyan|
plaid brown|drab indigo|
faded cyan|light lavender|
drab orange|plaid teal|clear fuchsia|
muted tan|faded bronze|vibrant green|
dull cyan|striped maroon|dim plum|
wavy red|mirrored fuchsia|vibrant salmon|
wavy lime|faded lavender|posh maroon|
dotted tan|shiny teal|plaid gray|pale silver|dim violet|
clear salmon|striped white|light coral|mirrored white|dotted silver|
dark purple|shiny lime|dull salmon|
dim purple|wavy beige|vibrant aqua|muted purple|
striped gray|muted lavender|clear blue|
bright yellow|bright fuchsia|drab brown|shiny lime|
light teal|faded olive|
wavy yellow|striped cyan|dim indigo|
vibrant tomato|shiny violet|mirrored blue|pale violet|faded olive|
pale silver|dotted magenta|mirrored salmon|dim blue|
mirrored lavender|pale teal|posh gray|
striped chartreuse|plaid bronze|
dotted chartreuse|pale white|striped tan|striped beige|dull brown|
muted silver|shiny tan|mirrored red|drab brown|
clear maroon|shiny gray|posh purple|pale silver|
light cyan|vibrant yellow|
plaid magenta|bright olive|faded violet|bright salmon|
drab gold|dull blue|mirrored gold|striped cyan|mirrored cyan|
light green|dotted brown|
dim silver|pale cyan|muted gold|faded fuchsia|
faded black|dim orange|shiny green|faded cyan|dull yellow|
bright bronze|plaid indigo|
light orange|wavy beige|mirrored blue|faded turquoise|
dark black|posh maroon|faded turquoise|drab violet|mirrored white|
dark gray|dotted coral|plaid bronze|
shiny aqua|muted coral|
striped aqua|posh bronze|
dull plum|drab gray|posh maroon|
posh salmon|mirrored bronze|plaid aqua|
muted blue|drab yellow|
dim lime|plaid teal|dotted orange|wavy silver|muted purple|
striped cyan|mirrored chartreuse|
dull beige|drab red|vibrant olive|
wavy indigo|pale orange|vibrant salmon|wavy red|plaid indigo|
drab tomato|clear gold|
shiny crimson|vibrant lime|shiny lavender|dark purple|light beige|
bright magenta|striped gray|dim cyan|
plaid maroon|bright magenta|dark olive|
faded white|faded turquoise|
pale plum|clear beige|mirrored violet|
dim fuchsia|posh maroon|dull tan|
dark olive|clear chartreuse|light cyan|striped magenta|
dull lime|striped lavender|shiny lavender|faded cyan|
faded fuchsia|wavy aqua|dark brown|pale orange|striped indigo|
posh olive|drab maroon|vibrant white|wavy lime|drab purple|
dull black|posh tomato|wavy aqua|dull tomato|clear orange|
striped blue|pale crimson|clear chartreuse|
shiny blue|plaid tan|plaid silver|
drab bronze|faded fuchsia|
posh aqua|dull turquoise|dim olive|
plaid lavender|mirrored red|striped salmon|mirrored turquoise|dotted cyan|
shiny purple|vibrant coral|striped blue|
mirrored purple|plaid teal|
vibrant coral|striped coral|pale gold|
drab blue|drab gray|vibrant coral|plaid teal|
mirrored green|dull brown|faded white|
dim beige|clear blue|shiny magenta|
striped tomato|vibrant silver|bright yellow|
clear bronze|striped coral|wavy green|bright violet|
shiny teal|drab white|
faded lavender|dim teal|faded olive|dim purple|pale gold|
posh gray|mirrored tan|
pale brown|dull tan|posh tomato|
shiny plum|mirrored blue|dark cyan|dark teal|
wavy lavender|wavy gold|wavy maroon|dark black|
shiny tan|bright bronze|posh fuchsia|dark maroon|wavy salmon|
dim coral|faded indigo|clear white|
mirrored turquoise|vibrant coral|pale gold|clear blue|
muted coral|no other|
drab plum|drab gray|dotted green|bright gray|
muted gold|shiny red|light white|mirrored maroon|
light violet|plaid tan|plaid turquoise|
dotted coral|dark crimson|muted plum|vibrant black|drab gray|
pale fuchsia|dark brown|
dark turquoise|plaid teal|dull orange|
dark blue|drab silver|shiny brown|
muted green|mirrored violet|posh silver|bright coral|clear chartreuse|
posh brown|mirrored turquoise|
vibrant tan|drab gray|
dull indigo|dim tomato|pale brown|
pale teal|light beige|plaid indigo|striped tan|vibrant white|
striped purple|drab white|
pale coral|plaid teal|
clear gold|muted purple|muted coral|
faded teal|pale tan|dark indigo|posh olive|
dotted orange|shiny brown|striped plum|plaid silver|
plaid olive|posh white|striped bronze|dark gold|plaid teal|
dark lime|mirrored gray|pale aqua|
mirrored maroon|muted beige|
shiny red|posh silver|shiny blue|
drab magenta|muted plum|light yellow|
plaid purple|no other|
drab indigo|dull blue|wavy maroon|pale gold|pale crimson|
vibrant white|dim salmon|
mirrored teal|dotted chartreuse|dim brown|striped yellow|
plaid gold|posh crimson|muted green|muted salmon|pale plum|
striped indigo|muted beige|mirrored fuchsia|
bright purple|dim violet|
dark salmon|clear silver|wavy fuchsia|bright salmon|
muted magenta|bright bronze|dark red|faded fuchsia|
drab olive|dim gold|clear gold|muted white|
mirrored black|dim teal|
dull bronze|dull white|striped yellow|striped crimson|pale teal|
dotted black|faded purple|vibrant coral|posh silver|vibrant aqua|
drab aqua|striped lavender|shiny lavender|
shiny maroon|posh crimson|drab blue|pale black|
faded plum|posh tomato|vibrant fuchsia|faded black|
wavy coral|shiny gold|
dull brown|mirrored tan|
pale gray|dim maroon|
dim tan|clear blue|wavy bronze|
plaid bronze|bright coral|dotted crimson|mirrored black|
|